00001000000
01101110110
01000111011
01111101101
01001000111
00000000100